[
  {
    "type": "mapgen",
    "om_terrain": "triffid_grove_z3",
    "fill_ter": "t_barkfloor",
    "rows": [
      ">,,,,>>>>>>>>>>>>>>>>>>>",
      ">,####,>>>>>>>>>>>>>>>>>",
      ">>,##,>>>>>>>>>>>>>>>>>>",
      ">>>>##>>>>>>>>>#####>>>>",
      ">>>#######>#####~~~##>>>",
      ">>>#~~~~~###~~~~~~~~#>>>",
      ">>>#~~~~~~~~~~~~~~~##>>>",
      ">>>#~~~~~~~~~~~~~~~#>>>>",
      ">>>#~~~~~~~~~~~~~~~#>>>>",
      ">>>#~~~~~~~~~~~~~~~##>>>",
      ">>>##~~~~~~~~~~~~~~~#>>>",
      ">>>>#~~~~~~~~~~~~~~~##>>",
      ">>>##~~~~~~~~~~~~~~##>>>",
      ">>>>#~~~~~~~~~~~~~~#>>>>",
      ">>>##~~~~~~~~~~~~~~#>>>>",
      ">>>#~~~~~~~~~~~~~~~##,,,",
      ">>>#~~~~~~~~~~~~~~~####,",
      ">>>#~~~~~~~~~~~~~~~###,,",
      ">>>######~~~~~~~~~~##>>>",
      ">>>###>>############>>>>",
      ">>,###,>>>>>####,##>>>>>",
      ">>###,>>>>>>>,###,>>>>>>",
      ">,##,>>>>>>>>>,##,>>>>>>",
      ">>>#,>>>>>>>>>>>,>>>>>>>"
    ],
    "palettes": [ "triffid" ],
    "terrain": { ">": "t_open_air" }
  },
  {
    "type": "mapgen",
    "om_terrain": [ "triffid_grove_z3" ],
    "weight": 100,
    "fill_ter": "t_barkfloor",
    "rows": [
      ">>>>>>>>>>>>,>>>>>>>>>>>",
      ">>>>>>>>>>,,#,>>>>>>>>>>",
      ">>>>>>>>>>###,>>>>>>>>>>",
      ">>>>>>>>>###>>>#####>>>>",
      ">>>#############~~~##>>>",
      ">>>#~~~~~###~~~~~~~~#>>>",
      ">>>#~~~~~~~~~~~~~~~##>>>",
      ">>>#~~~~~~~~~~~~~~~#>>>>",
      ",,##~~~~~~~~~~~~~~~#>>>>",
      "####~~~~~~~~~~~~~~~##>>>",
      "##,##~~~~~~~~~~~~~~~#>>>",
      ">>>>#~~~~~~~~~~~~~~~##>>",
      ">>>##~~~~~~~~~~~~~~##>>>",
      ">>>>#~~~~~~~~~~~~~~#>>>>",
      ">>>##~~~~~~~~~~~~~~#>>>>",
      ">>>#~~~~~~~~~~~~~~~##>>>",
      ">>>#~~~~~~~~~~~~~~~##>>>",
      ">>>#~~~~~~~~~~~~~~~#>>>>",
      ">>>######~~~~~~~~~~#>>>>",
      ">>>>>#>>############>>>>",
      ">>>>>>>>>>>>####>##>>>>>",
      ">>>>>>>>>>>>>>##,>>>>>>>",
      ">>>>>>>>>>>>>,####,>>>>>",
      ">>>>>>>>>>>>>>>,#,>>>>>>"
    ],
    "palettes": [ "triffid" ],
    "terrain": { ">": "t_open_air" }
  },
  {
    "type": "mapgen",
    "om_terrain": [ "triffid_grove_z3" ],
    "weight": 100,
    "fill_ter": "t_barkfloor",
    "rows": [
      ">>>>>>>>>>>>>>>>>>>>>>>>",
      ">>>>>>>>>>>>>>>>>>>>>>>>",
      ">>>>>>>>>>>>>>>>>>>>>>>>",
      ">>>>>>>>>>>>>>>#####>>>>",
      ">>>#######>#####~~~##>>>",
      ">>>#~~~~~###~~~~~~~~#>>>",
      ">>>#~~~~~~~~~~~~~~~##,>,",
      ">>>#~~~~~~~~~~~~~~~#####",
      ">>>#~~~~~~~~~~~~~~~###,>",
      ">>>#~~~~~~~~~~~~~~~##,>>",
      ">>>##~~~~~~~~~~~~~~~#>>>",
      ">>>>#~~~~~~~~~~~~~~~##>>",
      ">>>##~~~~~~~~~~~~~~##>>>",
      ">>>>#~~~~~~~~~~~~~~#>>>>",
      ">>>##~~~~~~~~~~~~~~#>>>>",
      ">>>#~~~~~~~~~~~~~~~##>>>",
      ">>>#~~~~~~~~~~~~~~~##>>>",
      ">>>#~~~~~~~~~~~~~~~#>>>>",
      ">>>######~~~~~~~~~~#>>>>",
      ">>>,################>>>>",
      ">>>####>>>>>##>>>##>>>>>",
      ">>,##,>>>>>>>>>>,#,>>>>>",
      ">>>#,>>>>>>>>>>>>##,>>>>",
      ">>>,>>>>>>>>>>>>>,#,>>>>"
    ],
    "palettes": [ "triffid" ],
    "terrain": { ">": "t_open_air" }
  }
]
